TORUS 42 11
##########################################
******************************************
******************************************
          P                    P          
                                          
        P E P                P h P        
                                          
          P                    P          
******************************************
******************************************
##########################################