PLANE 21 11
#####################
#   < * <   < * <   #
#   <   <   <   <   #
#   <   <   <   <   #
#   <   <   <   <   #
# * <   < * <   < * #
#   <   <   <   <   #
#   <   <   <   <   #
#   <   <   <   <   #
#   < * <   < * < h #
#####################
