PLANE 12 12
############
#h3  **  3*#
#2*      *4#
#  *    *  #
#   *  *   #
#*   **   *#
#*   **   *#
#   *  *   #
#  *    *  #
#2*      *4#
#*1  **  1*#
############