PLANE 12 12
############
#h*********#
#*  #  #  *#
#* #PvvP# *#
#*  #  #  *#
#*   **   *#
#*   **   *#
#*  #  #  *#
#* #P^^P# *#
#*  #  #  *#
#**********#
############