PLANE 12 12
############
#h*********#
#         *#
#******** *#
#*      * *#
#* **** * *#
#* *  * * *#
#* *    * *#
#* ****** *#
#*        *#
#**********#
############