PLANE 12 12
############
#h*      *P#
#*########*#
# #P*  *P# #
# #*#v##*# #
# # #**# # #
# # #**# # #
# #*####*# #
# #P*  *P# #
#*######^#*#
#P*      *P#
############










