PLANE 20 20
####################
#*   * v  *   * v *#
#*   * v  *   * v *#
#    * v  *   * v *#
#*                 #
#>>>>>>>>>>>>>     #
#*                *#
#*  <<<<<<<<<<<<<<<#
#*                *#
#>>>>>>>>>>>>>>>   #
#*                 #
#*       h         #
#                  #
#                  #
#              0   #
####################
#>>>>>>>>>>>>>>>>>v#
#^      * * *  0  v#
#^<<<<<<<<<<<<<<<<<#
####################
